R 1000       800





NO ./textures/redbrick.xpm    


WE ./textures/greystone.xpm
   EA ./textures/jungle-1.xpm
SO             ./textures/wood.xpm

C 225,30,0
F          220,    100,     0
S ./textures/barrel.xpm   

1111111111
1100000001
1000200201
1000000001
1000200001
1000000001
1010000001
1000000001
1000000N01
1111111111
